40 40
32 32
3 3 3 3 3 3 3 3 3 3 3 3 3 3 3 3 3 3 3 3 3 3 3 3 3 3 3 3 3 3 3 3 3 3 3 3 3 3 3 3
3 5 5 5 5 5 5 5 5 3 9 9 9 9 9 9 9 9 9 9 9 9 9 9 9 9 3 5 5 5 5 5 5 5 5 5 5 5 5 3
3 5 5 5 5 5 5 5 5 3 9 9 9 9 9 9 9 7 7 9 9 9 9 9 9 9 3 5 5 5 5 5 5 5 5 5 5 5 5 3
3 5 5 5 5 5 5 5 5 3 9 9 9 9 9 9 9 7 7 9 9 9 9 9 9 9 3 5 5 5 5 5 5 5 5 5 5 5 5 3
3 5 5 5 5 5 5 5 5 3 9 9 9 9 9 9 9 7 7 9 9 9 9 9 9 9 3 5 5 5 5 5 5 5 5 5 5 5 5 3
3 5 5 5 5 5 5 5 5 3 9 9 9 9 9 9 9 9 9 9 9 9 9 9 9 9 3 5 5 5 5 5 5 5 5 5 5 5 5 3
3 5 5 5 5 5 5 3 5 3 9 9 9 9 9 9 9 9 9 9 9 9 9 9 9 9 3 5 5 5 5 5 5 5 5 5 5 5 5 3
3 3 3 3 3 3 3 3 5 3 9 9 9 9 9 9 9 9 9 9 9 9 9 9 9 9 3 5 5 5 5 5 5 5 5 5 5 5 5 3
3 5 5 5 5 5 5 5 5 3 9 9 9 9 9 9 9 9 9 9 9 9 9 9 9 9 3 5 5 5 5 5 5 5 5 5 5 5 5 3
3 5 5 5 5 5 5 5 5 3 9 9 9 9 9 9 9 9 9 9 9 9 9 9 9 9 3 5 5 5 5 5 5 5 5 5 5 5 5 3
3 5 5 5 5 5 5 5 5 3 9 9 9 9 9 9 9 9 9 9 9 9 9 9 9 9 3 5 5 5 5 5 5 5 5 5 5 5 5 3
3 5 5 5 5 5 5 5 5 3 9 9 9 9 9 9 9 9 9 9 9 9 9 9 9 9 3 5 5 5 5 5 5 5 5 5 5 5 5 3
3 5 5 5 5 5 5 5 5 5 5 5 5 5 5 5 5 5 5 5 5 5 5 5 5 5 5 5 5 5 5 5 5 5 5 5 5 5 5 3
3 5 5 5 5 5 5 5 5 5 5 5 5 5 5 5 5 5 5 5 5 5 5 5 5 5 5 5 5 5 5 5 5 5 5 5 5 5 5 3
3 5 5 5 5 5 5 5 5 5 5 5 5 10 10 10 10 5 5 5 5 5 5 5 5 5 5 5 5 5 5 5 5 5 5 5 5 5 5 3
3 5 5 5 5 5 5 5 5 5 5 5 5 10 10 10 10 5 5 5 5 5 5 5 5 5 5 5 5 5 5 5 5 5 5 5 5 5 5 3
3 5 5 5 5 5 5 5 5 5 5 5 5 11 11 12 11 5 5 5 5 5 5 5 5 5 5 5 5 5 5 5 5 5 5 5 5 5 5 3
3 5 5 5 5 5 5 5 5 5 5 5 5 5 5 5 5 5 5 5 5 5 5 5 5 5 5 5 5 5 5 5 5 5 5 5 5 5 5 3
3 5 5 5 5 5 5 5 5 5 5 5 5 5 5 5 5 5 5 5 5 5 5 5 5 5 5 5 5 5 5 5 5 5 5 5 5 5 5 3
3 5 5 5 5 5 5 5 5 5 5 5 5 5 5 5 5 5 5 5 5 5 5 5 5 5 5 5 5 5 5 5 5 5 5 5 5 5 5 3
3 5 5 5 5 5 5 5 5 5 5 5 5 5 5 5 5 5 5 5 5 5 5 5 5 5 5 5 5 5 5 5 5 5 5 5 5 5 5 3
3 5 5 5 5 5 5 5 5 5 5 5 5 5 5 5 5 5 5 5 5 5 5 5 5 5 5 5 5 5 5 5 5 5 5 5 5 5 5 3
3 5 5 5 5 5 5 5 5 5 5 5 5 5 5 5 5 5 5 5 5 5 5 5 5 5 5 5 5 5 5 5 5 5 5 5 5 5 5 3
3 5 5 5 5 5 5 5 5 5 5 5 5 5 5 5 5 5 5 5 5 5 5 5 5 5 5 5 5 5 5 5 5 5 5 5 5 5 5 3
3 5 5 5 5 5 5 5 5 5 5 5 5 5 5 5 5 5 5 5 5 5 5 5 5 5 5 5 5 5 5 5 5 5 5 5 5 5 5 3
3 5 5 5 5 5 5 5 5 5 5 5 5 5 5 5 5 5 5 5 5 5 5 5 5 5 5 5 5 5 5 5 5 5 5 5 5 5 5 3
3 5 5 5 5 5 5 5 5 5 5 5 5 5 5 5 5 5 5 5 5 5 5 5 5 5 5 5 5 5 5 5 5 5 5 5 5 5 5 3
3 5 5 5 5 5 5 5 5 5 5 5 5 5 5 5 5 5 5 5 5 5 5 5 5 5 5 5 5 5 5 5 5 5 5 5 5 5 5 3
3 5 5 5 5 5 5 5 5 5 5 5 5 5 5 5 5 5 5 5 5 5 5 5 5 5 5 5 5 5 5 5 5 5 5 5 5 5 5 3
3 5 5 5 5 5 5 5 5 5 5 5 5 5 5 5 5 5 5 5 5 5 5 5 5 5 5 5 5 5 5 5 5 5 5 5 5 5 5 3
3 5 5 5 5 5 5 5 5 5 5 5 5 5 5 5 5 5 5 5 5 5 5 5 5 5 5 5 5 5 5 5 5 5 5 5 5 5 5 3
3 5 5 5 5 5 5 5 5 5 5 5 5 5 5 5 5 5 5 5 5 5 5 5 5 5 5 5 5 5 5 5 5 5 5 5 5 5 5 3
3 5 5 5 5 5 5 5 5 5 5 5 5 5 5 5 5 5 5 5 5 5 5 5 5 5 5 5 5 5 5 5 5 5 5 5 5 5 5 3
3 5 5 5 5 5 5 5 5 5 5 5 5 5 5 5 5 5 5 5 5 5 5 5 5 5 5 5 5 5 5 5 5 5 5 5 5 5 5 3
3 5 5 5 5 5 5 5 5 5 5 5 5 5 5 5 5 5 5 5 5 5 5 5 5 5 5 5 5 5 5 5 5 5 5 5 5 5 5 3
3 5 5 5 5 5 5 5 5 5 5 5 5 5 5 5 5 5 5 5 5 5 5 5 5 5 5 5 5 5 5 5 5 5 5 5 5 5 5 3
3 5 5 5 5 5 5 5 5 5 5 5 5 5 5 5 5 5 5 5 5 5 5 5 5 5 5 5 5 5 5 5 5 5 5 5 5 5 5 3
3 5 5 5 5 5 5 5 5 5 5 5 5 5 5 5 5 5 5 5 5 5 5 5 5 5 5 5 5 5 5 5 5 5 5 5 5 5 5 3
3 5 5 5 5 5 5 5 5 5 5 5 5 5 5 5 5 5 5 5 5 5 5 5 5 5 5 5 5 5 5 5 5 5 5 5 5 5 5 3
3 3 3 3 3 3 3 3 3 3 3 3 3 3 3 3 3 3 3 3 3 3 3 3 3 3 3 3 3 3 3 3 3 3 3 3 3 3 3 3
