40 40
32 32
402 402 402 402 402 402 402 402 402 402 402 402 402 402 402 402 402 402 402 402 402 402 402 402 402 402 402 402 402 402 402 402 402 402 402 402 402 402 402 402
402 100 100 100 100 100 100 100 100 402 408 408 408 408 408 408 408 408 408 408 408 408 408 408 408 408 402 100 100 100 100 100 100 100 100 100 100 100 100 402
402 100 100 100 100 100 100 100 100 402 408 408 408 408 408 408 408 110 110 408 408 408 408 408 408 408 402 100 100 100 100 100 100 100 100 100 100 100 100 402
402 100 100 100 100 100 100 100 100 402 408 408 408 408 408 408 408 110 110 408 408 408 408 408 408 408 402 100 100 100 100 100 100 100 100 100 100 100 100 402
402 100 100 100 100 100 100 100 100 402 408 408 408 408 408 408 408 110 110 408 408 408 408 408 408 408 402 100 100 100 100 100 100 100 100 100 100 100 100 402
402 100 100 100 100 100 100 100 100 402 408 408 408 408 408 408 408 408 408 408 408 408 408 408 408 408 402 100 100 100 100 100 100 100 100 100 100 100 100 402
402 100 100 100 100 100 100 100 100 402 408 408 408 408 408 408 408 408 408 408 408 408 408 408 408 408 402 100 100 100 100 100 100 100 100 100 100 100 100 402
402 100 100 100 100 100 100 100 100 402 408 408 408 408 408 408 408 408 408 408 408 408 408 408 408 408 402 100 100 100 100 100 100 100 100 100 100 100 100 402
402 100 100 100 100 100 100 100 100 402 408 408 408 408 408 408 408 408 408 408 408 408 408 408 408 408 402 100 100 100 100 100 100 100 100 100 100 100 100 402
402 100 100 100 100 100 100 100 100 402 408 408 408 408 408 408 408 408 408 408 408 408 408 408 408 408 402 100 100 100 100 100 100 100 100 100 100 100 100 402
402 100 100 100 100 100 100 100 100 402 408 408 408 408 408 408 408 408 408 408 408 408 408 408 408 408 402 100 100 100 100 100 100 100 100 100 100 100 100 402
402 100 100 100 100 100 100 100 100 402 408 408 408 408 408 408 408 408 408 408 408 408 408 408 408 408 402 100 100 100 100 100 100 100 100 100 100 100 100 402
402 100 100 100 100 100 100 100 100 100 100 100 100 100 100 100 100 100 100 100 100 100 100 100 100 100 100 100 100 100 100 100 100 100 100 100 100 100 100 402
402 100 100 100 100 100 100 100 100 100 100 100 100 100 100 100 100 100 100 100 100 100 100 100 100 100 100 100 100 100 100 100 100 100 100 100 100 100 100 402
402 100 100 100 100 100 100 100 100 100 100 100 100 409 409 409 409 100 100 100 100 100 100 100 100 100 100 100 100 100 100 100 100 100 100 100 100 100 100 402
402 100 100 100 100 100 100 100 100 100 100 100 100 409 409 409 409 100 100 100 100 100 100 100 100 100 100 100 100 100 100 100 100 100 100 100 100 100 100 402
402 100 100 100 100 100 100 100 100 100 100 100 100 410 410 411 410 100 100 100 100 100 100 100 100 100 100 100 100 100 100 100 100 100 100 100 100 100 100 402
402 100 100 100 100 100 100 100 100 100 100 100 100 100 100 100 100 100 100 100 100 100 110 110 111 112 113 100 100 100 100 100 100 100 100 100 100 100 100 402
402 100 100 110 110 110 110 110 110 110 110 110 100 100 100 100 100 100 100 100 100 100 110 110 114 110 115 100 100 100 100 100 100 100 100 100 100 100 100 402
402 100 100 110 110 110 110 110 110 110 110 110 100 100 100 100 100 100 100 100 100 100 110 110 116 117 118 100 100 100 100 100 100 100 100 100 100 100 100 402
402 100 100 110 110 110 110 110 110 110 110 110 100 100 100 100 100 100 100 100 100 100 110 110 110 110 110 100 100 100 100 100 100 100 100 100 100 100 100 402
402 100 100 110 110 110 110 110 110 110 110 110 100 100 100 100 100 100 100 100 100 100 110 110 110 110 110 100 100 100 100 100 100 100 100 100 100 100 100 402
402 100 100 110 110 110 110 110 110 110 110 110 100 100 100 100 100 100 100 100 100 100 110 121 122 123 110 100 100 100 100 100 100 100 100 100 100 100 100 402
402 100 100 110 110 110 110 110 110 110 110 110 100 100 100 100 100 100 100 100 100 100 110 124 120 125 110 100 100 100 100 100 100 100 100 100 100 100 100 402
402 100 100 110 110 110 110 110 110 110 110 110 100 100 100 100 100 100 100 100 100 100 110 126 127 128 110 100 100 100 100 100 100 100 100 100 100 100 100 402
402 100 100 110 110 110 110 110 110 110 110 100 100 100 100 100 100 100 100 100 100 100 110 110 110 110 110 100 100 100 100 100 100 100 100 100 100 100 100 402
402 100 100 110 110 110 110 110 110 110 110 100 102 103 103 103 103 104 100 100 100 100 100 100 100 100 100 100 100 100 100 100 100 100 100 100 100 100 100 402
402 100 100 110 110 110 110 110 110 110 110 100 105 101 101 101 101 106 100 100 100 100 100 100 100 100 100 100 100 100 100 100 100 100 100 100 100 100 100 402
402 100 100 110 110 110 110 110 110 110 110 100 105 101 101 101 101 106 100 100 100 100 100 100 100 100 100 100 100 100 100 100 100 100 100 100 100 100 100 402
402 100 100 110 110 110 110 110 110 110 110 100 105 101 101 101 101 106 100 100 100 100 100 100 100 100 100 100 100 100 100 100 100 100 100 100 100 100 100 402
402 100 100 110 110 110 110 110 110 110 110 100 105 101 101 101 101 106 100 100 100 100 100 100 100 100 100 100 100 100 100 100 100 100 100 100 100 100 100 402
402 100 100 110 110 110 110 110 110 110 110 100 107 108 108 108 108 109 100 100 100 100 100 100 100 100 100 100 100 100 100 100 100 100 100 100 100 100 100 402
402 100 100 110 110 110 110 110 110 110 110 100 100 100 100 100 100 100 100 100 100 100 100 100 100 100 100 100 100 100 100 100 100 100 100 100 100 100 100 402
402 100 100 110 110 110 110 110 110 110 110 100 100 100 100 100 100 100 100 100 100 100 100 100 100 100 100 100 100 100 100 100 100 100 100 100 100 100 100 402
402 100 100 110 110 110 110 110 110 110 110 100 100 100 100 100 100 100 100 100 100 100 100 100 100 100 100 100 100 100 100 100 100 100 100 100 100 100 100 402
402 100 100 110 110 110 110 110 110 110 110 100 100 100 100 100 100 100 100 100 100 100 100 100 100 100 100 100 100 100 100 100 100 100 100 100 100 100 100 402
402 100 100 110 110 110 110 110 110 110 110 100 100 100 100 100 100 100 100 100 100 100 100 100 100 100 100 100 100 100 100 100 100 100 100 100 100 100 100 402
402 402 402 402 402 402 402 402 402 402 402 402 402 402 402 402 402 402 402 402 402 402 402 402 402 402 402 402 402 402 402 402 402 402 402 402 402 402 402 402
402 402 402 402 402 402 402 402 402 402 402 402 402 402 402 402 402 402 402 402 402 402 402 402 402 402 402 402 402 402 402 402 402 402 402 402 402 402 402 402
402 402 402 402 402 402 402 402 402 402 402 402 402 402 402 402 402 402 402 402 402 402 402 402 402 402 402 402 402 402 402 402 402 402 402 402 402 402 402 402
