20 21
32 32
3 3 3 3 3 3 3 3 3 3 3 3 3 3 3 3 3 3 3 3
3 8 8 8 8 8 8 8 8 8 8 8 8 8 8 8 8 8 8 3
3 8 8 8 8 8 8 8 8 8 8 8 8 8 8 8 8 8 8 3
3 8 8 8 8 8 8 8 8 8 8 8 8 8 8 8 8 8 8 3
3 8 8 8 8 8 8 8 8 8 8 8 8 8 8 8 8 8 8 3
3 8 8 8 8 1 1 1 1 1 1 1 1 1 8 8 8 8 8 3 
3 8 8 8 8 1 2 2 2 2 2 2 2 1 8 8 8 8 8 3
3 8 8 8 8 1 2 2 2 2 2 2 2 1 8 8 8 8 8 3
3 8 8 8 8 1 2 2 2 2 2 2 2 1 8 8 8 8 8 3
3 8 8 8 8 1 6 5 4 4 4 5 6 1 8 8 8 8 8 3
3 8 8 8 8 1 6 5 4 4 4 5 6 1 8 8 8 8 8 3 
3 8 8 8 8 1 6 5 5 5 5 5 6 1 8 8 8 8 8 3
3 8 8 8 8 1 6 6 7 7 7 6 6 1 8 8 8 8 8 3
3 8 8 8 8 1 6 6 7 7 7 6 6 1 8 8 8 8 8 3
3 8 8 8 8 1 6 6 7 7 7 6 6 1 8 8 8 8 8 3
3 8 8 8 8 1 1 1 7 7 7 1 1 1 8 8 8 8 8 3 
3 8 8 8 8 8 8 1 0 0 0 1 8 8 8 8 8 8 8 3
3 8 8 8 8 8 8 1 0 0 0 1 8 8 8 8 8 8 8 3
3 8 8 8 8 8 8 1 0 0 0 1 8 8 8 8 8 8 8 3
3 3 3 3 3 3 3 3 3 3 3 3 8 8 3 3 3 3 3 3
3 3 3 3 3 3 3 3 3 3 3 3 8 8 3 3 3 3 3 3