40 40
32 32
402 402 402 402 402 402 402 402 402 402 402 402 402 402 402 402 402 402 402 402 402 402 402 402 402 402 402 402 402 402 402 402 402 402 402 402 402 402 402 402
402 100 100 100 100 100 100 100 100 402 408 408 408 408 408 408 408 408 408 408 408 408 408 408 408 408 402 100 100 100 100 100 100 100 100 100 100 100 100 402
402 100 100 100 100 100 100 100 100 402 408 408 408 408 408 408 408 406 406 408 408 408 408 408 408 408 402 100 100 100 100 100 100 100 100 100 100 100 100 402
402 100 100 100 100 100 100 100 100 402 408 408 408 408 408 408 408 406 406 408 408 408 408 408 408 408 402 100 100 100 100 100 100 100 100 100 100 100 100 402
402 100 100 100 100 100 100 100 100 402 408 408 408 408 408 408 408 406 406 408 408 408 408 408 408 408 402 100 100 100 100 100 100 100 100 100 100 100 100 402
402 100 100 100 100 100 100 100 100 402 408 408 408 408 408 408 408 408 408 408 408 408 408 408 408 408 402 100 100 100 100 100 100 100 100 100 100 100 100 402
402 100 100 100 100 100 100 100 100 402 408 408 408 408 408 408 408 408 408 408 408 408 408 408 408 408 402 100 100 100 100 100 100 100 100 100 100 100 100 402
402 100 100 100 100 100 100 100 100 402 408 408 408 408 408 408 408 408 408 408 408 408 408 408 408 408 402 100 100 100 100 100 100 100 100 100 100 100 100 402
402 100 100 100 100 100 100 100 100 402 408 408 408 408 408 408 408 408 408 408 408 408 408 408 408 408 402 100 100 100 100 100 100 100 100 100 100 100 100 402
402 100 100 100 100 100 100 100 100 402 408 408 408 408 408 408 408 408 408 408 408 408 408 408 408 408 402 100 100 100 100 100 100 100 100 100 100 100 100 402
402 100 100 100 100 100 100 100 100 402 408 408 408 408 408 408 408 408 408 408 408 408 408 408 408 408 402 100 100 100 100 100 100 100 100 100 100 100 100 402
402 100 100 100 100 100 100 100 100 402 408 408 408 408 408 408 408 408 408 408 408 408 408 408 408 408 402 100 100 100 100 100 100 100 100 100 100 100 100 402
402 100 100 100 100 100 100 100 100 100 100 100 100 100 100 100 100 100 100 100 100 100 100 100 100 100 100 100 100 100 100 100 100 100 100 100 100 100 100 402
402 100 100 100 100 100 100 100 100 100 100 100 100 100 100 100 100 100 100 100 100 100 100 100 100 100 100 100 100 100 100 100 100 100 100 100 100 100 100 402
402 100 100 100 100 100 100 100 100 100 100 100 100 409 409 409 409 100 100 100 100 100 100 100 100 100 100 100 100 100 100 100 100 100 100 100 100 100 100 402
402 100 100 100 100 100 100 100 100 100 100 100 100 409 409 409 409 100 100 100 100 100 100 100 100 100 100 100 100 100 100 100 100 100 100 100 100 100 100 402
402 100 100 100 100 100 100 100 100 100 100 100 100 410 410 411 410 100 100 100 100 100 100 100 100 100 100 100 100 100 100 100 100 100 100 100 100 100 100 402
402 100 100 100 100 100 100 100 100 100 100 100 100 100 100 100 100 100 100 100 100 100 100 100 100 100 100 100 100 100 100 100 100 100 100 100 100 100 100 402
402 100 100 406 406 406 406 406 406 406 406 406 100 100 100 100 100 100 100 100 100 100 100 100 100 100 100 100 100 100 100 100 100 100 100 100 100 100 100 402
402 100 100 406 406 406 406 406 406 406 406 406 100 100 100 100 100 100 100 100 100 100 100 100 100 100 100 100 100 100 100 100 100 100 100 100 100 100 100 402
402 100 100 406 406 406 406 406 406 406 406 406 100 100 100 100 100 100 100 100 100 100 100 100 100 100 100 100 100 100 100 100 100 100 100 100 100 100 100 402
402 100 100 406 406 406 406 406 406 406 406 406 100 100 100 100 100 100 100 100 100 100 100 100 100 100 100 100 100 100 100 100 100 100 100 100 100 100 100 402
402 100 100 406 406 406 406 406 406 406 406 406 100 100 100 100 100 100 100 100 100 100 100 100 100 100 100 100 100 100 100 100 100 100 100 100 100 100 100 402
402 100 100 406 406 406 406 406 406 406 406 406 100 100 100 100 100 100 100 100 100 100 100 100 100 100 100 100 100 100 100 100 100 100 100 100 100 100 100 402
402 100 100 406 406 406 406 406 406 406 406 406 100 100 100 100 100 100 100 100 100 100 100 100 100 100 100 100 100 100 100 100 100 100 100 100 100 100 100 402
402 100 100 406 406 406 406 406 406 406 406 100 100 100 100 100 100 100 100 100 100 100 100 100 100 100 100 100 100 100 100 100 100 100 100 100 100 100 100 402
402 100 100 406 406 406 406 406 406 406 406 100 101 102 102 102 102 103 100 100 100 100 100 100 100 100 100 100 100 100 100 100 100 100 100 100 100 100 100 402
402 100 100 406 406 406 406 406 406 406 406 100 104 105 105 105 105 106 100 100 100 100 100 100 100 100 100 100 100 100 100 100 100 100 100 100 100 100 100 402
402 100 100 406 406 406 406 406 406 406 406 100 104 105 105 105 105 106 100 100 100 100 100 100 100 100 100 100 100 100 100 100 100 100 100 100 100 100 100 402
402 100 100 406 406 406 406 406 406 406 406 100 104 105 105 105 105 106 100 100 100 100 100 100 100 100 100 100 100 100 100 100 100 100 100 100 100 100 100 402
402 100 100 406 406 406 406 406 406 406 406 100 104 105 105 105 105 106 100 100 100 100 100 100 100 100 100 100 100 100 100 100 100 100 100 100 100 100 100 402
402 100 100 406 406 406 406 406 406 406 406 100 107 108 108 108 108 109 100 100 100 100 100 100 100 100 100 100 100 100 100 100 100 100 100 100 100 100 100 402
402 100 100 406 406 406 406 406 406 406 406 100 100 100 100 100 100 100 100 100 100 100 100 100 100 100 100 100 100 100 100 100 100 100 100 100 100 100 100 402
402 100 100 406 406 406 406 406 406 406 406 100 100 100 100 100 100 100 100 100 100 100 100 100 100 100 100 100 100 100 100 100 100 100 100 100 100 100 100 402
402 100 100 406 406 406 406 406 406 406 406 100 100 100 100 100 100 100 100 100 100 100 100 100 100 100 100 100 100 100 100 100 100 100 100 100 100 100 100 402
402 100 100 406 406 406 406 406 406 406 406 100 100 100 100 100 100 100 100 100 100 100 100 100 100 100 100 100 100 100 100 100 100 100 100 100 100 100 100 402
402 100 100 406 406 406 406 406 406 406 406 100 100 100 100 100 100 100 100 100 100 100 100 100 100 100 100 100 100 100 100 100 100 100 100 100 100 100 100 402
402 402 402 402 402 402 402 402 402 402 402 402 402 402 402 402 402 402 402 402 402 402 402 402 402 402 402 402 402 402 402 402 402 402 402 402 402 402 402 402
402 402 402 402 402 402 402 402 402 402 402 402 402 402 402 402 402 402 402 402 402 402 402 402 402 402 402 402 402 402 402 402 402 402 402 402 402 402 402 402
402 402 402 402 402 402 402 402 402 402 402 402 402 402 402 402 402 402 402 402 402 402 402 402 402 402 402 402 402 402 402 402 402 402 402 402 402 402 402 402
