40 40
32 32
402 402 402 402 402 402 402 402 402 402 402 402 402 402 402 402 402 402 402 402 402 402 402 402 402 402 402 402 402 402 402 402 402 402 402 402 402 402 402 402
402 100 100 100 100 100 100 100 100 402 408 408 408 408 408 408 408 408 408 408 408 408 408 408 408 408 402 110 110 110 110 110 100 100 100 100 100 100 100 402
402 100 100 100 100 100 100 100 100 402 408 408 408 408 408 408 408 110 110 408 408 408 408 408 408 408 402 110 131 132 133 110 100 141 142 143 100 100 100 402
402 122 123 100 100 100 100 100 100 402 408 408 408 408 408 408 408 110 110 408 408 408 408 408 408 408 402 110 134 130 135 110 100 144 130 145 100 100 100 402
402 120 125 100 100 100 100 100 100 402 408 408 408 408 408 408 408 110 110 408 408 408 408 408 408 408 402 110 136 137 138 110 100 146 147 148 100 100 100 402
402 120 125 100 100 100 100 100 100 402 408 408 408 408 408 408 408 408 408 408 408 408 408 408 408 408 402 110 110 110 110 110 100 100 100 100 100 100 100 402
402 120 125 100 100 100 100 100 100 402 408 408 408 408 408 408 408 408 408 408 408 408 408 408 408 408 402 110 171 172 173 110 100 100 100 100 100 100 100 402
402 120 125 100 100 100 100 100 100 402 408 408 408 408 408 408 408 408 408 408 408 408 408 408 408 408 402 110 174 160 175 110 130 130 130 130 130 130 130 402
402 120 125 100 100 100 100 100 100 402 408 408 408 408 408 408 408 408 408 408 408 408 408 408 408 408 402 110 176 177 178 110 130 151 152 153 130 100 100 402
402 120 125 100 100 100 100 100 100 402 408 408 408 408 408 408 408 408 408 408 408 408 408 408 408 408 402 110 110 110 110 110 130 154 101 155 130 100 100 402
402 120 120 112 112 113 100 100 100 402 408 408 408 408 408 408 408 408 408 408 408 408 408 408 408 408 402 110 100 100 100 100 130 156 157 158 130 100 100 402
402 120 120 122 122 115 100 100 100 402 408 408 408 408 408 408 408 408 408 408 408 408 408 408 408 408 402 110 100 100 100 100 130 130 130 130 130 100 100 402
402 120 120 120 120 115 100 100 100 100 100 100 100 100 100 100 100 100 100 100 100 100 100 100 100 100 100 100 100 100 100 100 130 181 182 183 130 100 100 402
402 120 120 120 120 115 100 100 100 100 100 100 100 100 100 100 100 100 100 100 100 100 100 100 100 100 100 100 100 100 100 100 130 184 120 185 130 100 100 402
402 120 117 117 117 118 100 100 100 100 100 100 100 409 409 409 409 100 100 100 100 100 100 100 100 100 100 100 100 100 100 100 130 186 187 188 130 100 100 402
402 120 100 132 132 131 100 100 100 100 100 100 100 409 409 409 409 100 100 100 100 100 100 100 100 100 100 100 100 100 100 100 130 130 130 130 130 100 100 402
402 120 100 100 100 100 100 100 100 100 100 100 100 410 410 411 410 100 100 100 100 100 100 100 100 100 100 100 100 100 100 100 100 100 100 100 100 100 100 402
402 120 100 100 100 100 100 100 100 100 100 100 100 100 100 100 100 100 100 100 100 100 110 110 111 112 113 100 100 100 100 101 101 101 101 101 100 100 100 402
402 120 100 110 110 110 110 110 110 110 110 110 100 100 100 100 100 100 100 100 100 100 110 110 114 110 115 100 100 100 100 101 161 162 163 101 100 100 100 402
402 120 100 110 110 110 110 110 110 110 110 110 100 100 100 100 100 100 100 100 100 100 110 110 116 117 118 100 100 100 100 101 164 160 165 101 100 100 100 402
402 120 100 110 110 110 110 110 110 110 110 110 100 100 100 100 100 100 100 100 100 100 110 110 110 110 110 100 100 100 100 101 166 167 168 101 100 100 100 402
402 120 100 110 110 110 110 110 110 110 110 110 100 100 100 100 100 100 100 100 100 100 110 110 110 110 110 100 100 100 100 101 101 101 101 101 100 100 100 402
402 120 100 110 110 110 110 110 110 110 110 110 100 100 100 100 100 100 100 100 100 100 110 121 122 123 110 100 100 100 100 100 100 100 100 100 100 100 100 402
402 100 100 110 110 110 110 110 110 110 110 110 100 100 100 100 100 100 100 100 100 100 110 124 120 125 110 100 100 100 100 100 100 100 100 100 100 100 100 402
402 100 100 110 110 110 110 110 110 110 110 110 100 100 100 100 100 100 100 100 100 100 110 126 127 128 110 100 100 100 100 100 100 100 100 100 100 100 100 402
402 100 100 110 110 110 110 110 110 110 110 100 100 100 100 100 100 100 100 100 100 100 110 110 110 110 110 100 100 100 100 100 100 100 100 100 100 100 100 402
402 100 100 110 110 110 110 110 110 110 110 100 102 103 103 103 103 104 100 100 100 100 100 100 100 100 100 100 100 100 100 100 100 100 100 100 100 100 100 402
402 100 100 110 110 110 110 110 110 110 110 100 105 101 101 101 101 106 100 100 100 100 100 100 100 100 100 100 100 100 100 100 100 100 100 100 100 100 100 402
402 100 100 110 110 110 110 110 110 110 110 100 105 101 101 101 101 106 100 100 100 100 100 100 100 100 100 100 100 100 100 100 100 100 100 100 100 100 100 402
402 100 100 110 110 110 110 110 110 110 110 100 105 101 101 101 101 106 100 100 100 100 100 100 100 100 100 100 100 100 100 100 100 100 100 100 100 100 100 402
402 100 100 110 110 110 110 110 110 110 110 100 105 101 101 101 101 106 100 100 100 100 100 100 100 100 100 100 100 100 100 100 100 100 100 100 100 100 100 402
402 100 100 110 110 110 110 110 110 110 110 100 107 108 108 108 108 109 100 100 100 100 100 100 100 100 100 100 100 100 100 100 100 100 100 100 100 100 100 402
402 100 100 110 110 110 110 110 110 110 110 100 100 100 100 100 100 100 100 100 100 100 100 100 100 100 100 100 100 100 100 100 100 100 100 100 100 100 100 402
402 100 100 110 110 110 110 110 110 110 110 100 100 100 100 100 100 100 100 100 100 100 100 100 100 100 100 100 100 100 100 100 100 100 100 100 100 100 100 402
402 100 100 110 110 110 110 110 110 110 110 100 100 100 100 100 100 100 100 100 100 100 100 100 100 100 100 100 100 100 100 100 100 100 100 100 100 100 100 402
402 100 100 110 110 110 110 110 110 110 110 100 100 100 100 100 100 100 100 100 100 100 100 100 100 100 100 100 100 100 100 100 100 100 100 100 100 100 100 402
402 100 100 110 110 110 110 110 110 110 110 100 100 100 100 100 100 100 100 100 100 100 100 100 100 100 100 100 100 100 100 100 100 100 100 100 100 100 100 402
402 402 402 402 402 402 402 402 402 402 402 402 402 402 402 402 402 402 402 402 402 402 402 402 402 402 402 402 402 402 402 402 402 402 402 402 402 402 402 402
402 402 402 402 402 402 402 402 402 402 402 402 402 402 402 402 402 402 402 402 402 402 402 402 402 402 402 402 402 402 402 402 402 402 402 402 402 402 402 402
402 402 402 402 402 402 402 402 402 402 402 402 402 402 402 402 402 402 402 402 402 402 402 402 402 402 402 402 402 402 402 402 402 402 402 402 402 402 402 402
