40 40
32 32
103 103 103 103 103 103 103 103 103 103 103 103 103 103 103 103 103 103 103 103 103 103 103 103 103 103 103 103 103 103 103 103 103 103 103 103 103 103 103 103
103 101 113 101 101 101 101 101 101 103 011 109 109 109 109 109 109 109 109 109 109 109 109 109 109 109 103 101 101 101 101 101 101 101 101 101 101 101 101 103
103 101 114 101 101 101 101 101 101 103 011 109 109 109 109 109 109 107 107 109 109 109 109 109 109 109 103 101 101 101 101 101 101 101 101 101 101 101 101 103
103 101 114 101 101 101 101 101 101 103 011 109 109 109 109 109 109 107 107 109 109 109 109 109 109 109 103 101 101 101 101 101 101 101 101 101 101 101 101 103
103 101 113 101 101 101 101 101 101 103 011 109 109 109 109 109 109 107 107 109 109 109 109 109 109 109 103 101 101 101 101 101 101 101 101 101 101 101 101 103
103 101 101 101 101 101 101 101 101 103 011 109 109 109 109 109 109 109 109 109 109 109 109 109 109 109 103 101 101 101 101 101 101 101 101 101 101 101 101 103
103 101 101 101 101 101 101 103 101 103 011 109 109 109 109 109 109 109 109 109 109 109 109 109 109 109 103 101 101 101 101 101 101 101 101 101 101 101 101 103
103 101 101 101 101 101 101 101 101 103 011 109 109 109 109 109 109 109 109 109 109 109 109 109 109 109 103 101 101 101 101 101 101 101 101 101 101 101 101 103
103 101 101 101 101 101 101 101 101 103 011 109 109 109 109 109 109 109 109 109 109 109 109 109 109 109 103 101 101 101 101 101 101 101 101 101 101 101 101 103
103 101 101 101 101 101 101 101 101 103 011 109 109 109 109 109 109 109 109 109 109 109 109 109 109 109 103 101 101 101 101 101 101 101 101 101 101 101 101 103
103 101 101 101 101 101 101 101 101 103 011 109 109 109 109 109 109 109 109 109 109 109 109 109 109 109 103 101 101 101 101 101 101 101 101 101 101 101 101 103
103 101 101 101 101 101 101 101 101 103 011 109 109 109 109 109 109 109 109 109 109 109 109 109 109 109 103 101 101 101 101 101 101 101 101 101 101 101 101 103
103 101 101 101 101 101 101 101 101 101 101 101 101 101 101 101 101 101 101 101 101 101 101 101 101 101 101 101 101 101 101 101 101 101 101 101 101 101 101 103
103 101 101 101 101 101 101 101 101 101 101 101 101 101 101 101 101 101 101 101 101 101 101 101 101 101 101 101 101 101 101 101 101 101 101 101 101 101 101 103
103 101 101 101 101 101 101 101 101 101 101 101 101 110 110 110 110 101 101 101 101 101 101 101 101 101 101 101 101 101 101 101 101 101 101 101 101 101 101 103
103 101 101 101 101 101 101 101 101 101 101 101 101 110 110 110 110 101 101 101 101 101 101 101 101 101 101 101 101 101 101 101 101 101 101 101 101 101 101 103
103 101 101 101 101 101 101 101 101 101 101 101 101 111 111 112 111 101 101 101 101 101 101 101 101 101 101 101 101 101 101 101 101 101 101 101 101 101 101 103
103 101 101 101 101 101 101 101 101 101 101 101 101 101 101 101 101 101 101 101 101 101 101 101 101 101 101 101 101 101 101 101 101 101 101 101 101 101 101 103
103 101 101 107 107 107 107 107 107 107 107 107 101 101 101 101 101 101 101 101 101 101 101 101 101 101 101 101 101 101 101 101 101 101 101 101 101 101 101 103
103 101 101 107 107 107 107 107 107 107 107 107 101 101 101 101 101 101 101 101 101 101 101 101 101 101 101 101 101 101 101 101 101 101 101 101 101 101 101 103
103 101 101 107 107 107 107 107 107 107 107 107 101 101 101 101 101 101 101 101 101 101 101 101 101 101 101 101 101 101 101 101 101 101 101 101 101 101 101 103
103 101 101 107 107 107 107 107 107 107 107 107 101 101 101 101 101 101 101 101 101 101 101 101 101 101 101 101 101 101 101 101 101 101 101 101 101 101 101 103
103 101 101 107 107 107 107 107 107 107 107 107 101 101 101 101 101 101 101 101 101 101 101 101 101 101 101 101 101 101 101 101 101 101 101 101 101 101 101 103
103 101 101 107 107 107 107 107 107 107 107 107 101 101 101 101 101 101 101 101 101 101 101 101 101 101 101 101 101 101 101 101 101 101 101 101 101 101 101 103
103 101 101 107 107 107 107 107 107 107 107 107 101 101 101 101 101 101 101 101 101 101 101 101 101 101 101 101 101 101 101 101 101 101 101 101 101 101 101 103
103 101 101 107 107 107 107 107 107 107 107 107 101 101 101 101 101 101 101 101 101 101 101 101 101 101 101 101 101 101 101 101 101 101 101 101 101 101 101 103
103 101 101 107 107 107 107 107 107 107 107 107 101 101 101 102 101 101 101 101 101 101 101 101 101 101 101 101 101 101 101 101 101 101 101 101 101 101 101 103
103 101 101 107 107 107 107 107 107 107 107 107 101 101 101 103 101 101 101 101 101 101 101 101 101 101 101 101 101 101 101 101 101 101 101 101 101 101 101 103
103 101 101 107 107 107 107 107 107 107 107 107 101 101 101 104 101 101 101 101 101 101 101 101 101 101 101 101 101 101 101 101 101 101 101 101 101 101 101 103
103 101 101 107 107 107 107 107 107 107 107 107 101 101 101 105 101 101 101 101 101 101 101 101 101 101 101 101 101 101 101 101 101 101 101 101 101 101 101 103
103 101 101 107 107 107 107 107 107 107 107 107 101 101 101 106 101 101 101 101 101 101 101 101 101 101 101 101 101 101 101 101 101 101 101 101 101 101 101 103
103 101 101 107 107 107 107 107 107 107 107 107 101 101 101 107 101 101 101 101 101 101 101 101 101 101 101 101 101 101 101 101 101 101 101 101 101 101 101 103
103 101 101 107 107 107 107 107 107 107 107 107 101 101 101 108 101 101 101 101 101 101 101 101 101 101 101 101 101 101 101 101 101 101 101 101 101 101 101 103
103 101 101 107 107 107 107 107 107 107 107 107 101 101 101 109 101 101 101 101 101 101 101 101 101 101 101 101 101 101 101 101 101 101 101 101 101 101 101 103
103 101 101 107 107 107 107 107 107 107 107 107 101 101 101 110 101 101 101 101 101 101 101 101 101 101 101 101 101 101 101 101 101 101 101 101 101 101 101 103
103 101 101 107 107 107 107 107 107 107 107 107 101 101 101 111 101 101 101 101 101 101 101 101 101 101 101 101 101 101 101 101 101 101 101 101 101 101 101 103
103 101 101 107 107 107 107 107 107 107 107 107 101 101 101 112 101 101 101 101 101 101 101 101 101 101 101 101 101 101 101 101 101 101 101 101 101 101 101 103
103 103 103 103 103 103 103 103 103 103 103 103 103 103 103 103 103 103 103 103 103 103 103 103 103 103 103 103 103 103 103 103 103 103 103 103 103 103 103 103
103 103 103 103 103 103 103 103 103 103 103 103 103 103 103 103 103 103 103 103 103 103 103 103 103 103 103 103 103 103 103 103 103 103 103 103 103 103 103 103
103 103 103 103 103 103 103 103 103 103 103 103 103 103 103 103 103 103 103 103 103 103 103 103 103 103 103 103 103 103 103 103 103 103 103 103 103 103 103 103