40 40
32 32
103 103 103 103 103 103 103 103 103 103 103 103 103 103 103 103 103 103 103 103 103 103 103 103 103 103 103 103 103 103 103 103 103 103 103 103 103 103 103 103
103 101 101 101 101 101 101 101 101 103 011 109 109 109 109 109 109 109 109 109 109 109 109 109 109 109 103 101 101 101 101 101 101 101 101 101 101 101 101 103
103 101 101 101 101 101 101 101 101 103 011 109 109 109 109 109 109 107 107 109 109 109 109 109 109 109 103 101 101 101 101 101 101 101 101 101 101 101 101 103
103 101 101 101 101 101 101 101 101 103 011 109 109 109 109 109 109 107 107 109 109 109 109 109 109 109 103 101 101 101 101 101 101 101 101 101 101 101 101 103
103 101 101 101 101 101 101 101 101 103 011 109 109 109 109 109 109 107 107 109 109 109 109 109 109 109 103 101 101 101 101 101 101 101 101 101 101 101 101 103
103 120 101 101 101 101 101 101 101 103 011 109 109 109 109 109 109 109 109 109 109 109 109 109 109 109 103 101 101 101 101 101 101 101 101 101 101 101 101 103
103 121 101 101 101 101 101 103 101 103 011 109 109 109 109 109 109 109 109 109 109 109 109 109 109 109 103 101 101 101 101 101 101 101 101 101 101 101 101 103
103 122 101 101 101 101 101 101 101 103 011 109 109 109 109 109 109 109 109 109 109 109 109 109 109 109 103 101 101 101 101 101 101 101 101 101 101 101 101 103
103 123 101 101 101 101 101 101 101 103 011 109 109 109 109 109 109 109 109 109 109 109 109 109 109 109 103 101 101 101 101 101 101 101 101 101 101 101 101 103
103 124 101 101 101 101 101 101 101 103 011 109 109 109 109 109 109 109 109 109 109 109 109 109 109 109 103 101 101 101 101 101 101 101 101 101 101 101 101 103
103 125 101 101 101 101 101 101 101 103 011 109 109 109 109 109 109 109 109 109 109 109 109 109 109 109 103 101 101 101 101 101 101 101 101 101 101 101 101 103
103 126 101 101 101 101 101 101 101 103 011 109 109 109 109 109 109 109 109 109 109 109 109 109 109 109 103 101 101 101 101 101 101 101 101 101 101 101 101 103
103 127 101 101 101 101 101 101 101 101 101 101 101 101 101 101 101 101 101 101 101 101 101 101 101 101 101 101 101 101 101 101 101 101 101 101 101 101 101 103
103 128 101 101 101 101 101 101 101 101 101 101 101 101 101 101 101 101 101 101 101 101 101 101 101 101 101 101 101 101 101 101 101 101 101 101 101 101 101 103
103 129 101 101 101 101 101 101 101 101 101 101 101 110 110 110 110 101 101 101 101 101 101 101 101 101 101 101 101 101 101 101 101 101 101 101 101 101 101 103
103 130 101 101 101 101 101 101 101 101 101 101 101 110 110 110 110 101 101 101 101 101 101 101 101 101 101 101 101 101 101 101 101 101 101 101 101 101 101 103
103 131 101 101 101 101 101 101 101 101 101 101 101 111 111 112 111 101 101 101 101 101 101 101 101 101 101 101 101 101 101 101 101 101 101 101 101 101 101 103
103 101 101 101 101 101 101 101 101 101 101 101 101 101 101 101 101 101 101 101 101 101 101 101 101 101 101 101 101 101 101 101 101 101 101 101 101 101 101 103
103 101 101 107 107 107 107 107 107 107 107 107 101 101 101 101 101 101 101 101 101 101 101 101 101 101 101 101 101 101 101 101 101 101 101 101 101 101 101 103
103 101 101 107 107 107 107 107 107 107 107 107 101 101 101 101 101 101 101 101 101 101 101 101 101 101 101 101 101 101 101 101 101 101 101 101 101 101 101 103
103 101 101 107 107 107 107 107 107 107 107 107 101 101 101 101 101 101 101 101 101 101 101 101 101 101 101 101 101 101 101 101 101 101 101 101 101 101 101 103
103 101 101 107 107 107 107 107 107 107 107 107 101 101 101 101 101 101 101 101 101 101 101 101 101 101 101 101 101 101 101 101 101 101 101 101 101 101 101 103
103 101 101 107 107 107 107 107 107 107 107 107 101 101 101 101 101 101 101 101 101 101 101 101 101 101 101 101 101 101 101 101 101 101 101 101 101 101 101 103
103 101 101 107 107 107 107 107 107 107 107 107 101 101 101 101 101 101 101 101 101 101 101 101 101 101 101 101 101 101 101 101 101 101 101 101 101 101 101 103
103 101 101 107 107 107 107 107 107 107 107 107 101 101 101 101 101 101 101 101 101 101 101 101 101 101 101 101 101 101 101 101 101 101 101 101 101 101 101 103
103 101 101 107 107 107 107 107 107 107 107 131 131 131 131 131 131 131 131 131 131 101 101 101 101 101 101 101 101 101 101 101 101 101 101 101 101 101 101 103
103 101 101 107 107 107 107 107 107 107 107 131 120 121 121 121 122 132 133 134 131 101 101 101 101 101 101 101 101 101 101 101 101 101 101 101 101 101 101 103
103 101 101 107 107 107 107 107 107 107 107 131 123 124 124 124 125 135 136 137 131 101 101 101 101 101 101 101 101 101 101 101 101 101 101 101 101 101 101 103
103 101 101 107 107 107 107 107 107 107 107 131 123 124 124 124 125 138 139 140 131 101 101 101 101 101 101 101 101 101 101 101 101 101 101 101 101 101 101 103
103 101 101 107 107 107 107 107 107 107 107 131 123 124 124 124 125 131 142 141 131 101 101 101 101 101 101 101 101 101 101 101 101 101 101 101 101 101 101 103
103 101 101 107 107 107 107 107 107 107 107 131 123 124 124 124 125 131 131 131 131 101 101 101 101 101 101 101 101 101 101 101 101 101 101 101 101 101 101 103
103 101 101 107 107 107 107 107 107 107 107 131 126 127 127 127 128 131 131 131 131 101 101 101 101 101 101 101 101 101 101 101 101 101 101 101 101 101 101 103
103 101 101 107 107 107 107 107 107 107 107 131 131 131 131 131 131 131 131 131 131 101 101 101 101 101 101 101 101 101 101 101 101 101 101 101 101 101 101 103
103 101 101 107 107 107 107 107 107 107 107 131 131 131 131 131 131 131 131 131 131 101 101 101 101 101 101 101 101 101 101 101 101 101 101 101 101 101 101 103
103 101 101 107 107 107 107 107 107 107 107 131 131 131 131 131 131 131 131 131 131 101 101 101 101 101 101 101 101 101 101 101 101 101 101 101 101 101 101 103
103 101 101 107 107 107 107 107 107 107 107 131 131 131 131 131 131 131 131 131 131 101 101 101 101 101 101 101 101 101 101 101 101 101 101 101 101 101 101 103
103 101 101 107 107 107 107 107 107 107 107 107 101 101 101 112 101 101 101 101 101 101 101 101 101 101 101 101 101 101 101 101 101 101 101 101 101 101 101 103
103 103 103 103 103 103 103 103 103 103 103 103 103 103 103 103 103 103 103 103 103 103 103 103 103 103 103 103 103 103 103 103 103 103 103 103 103 103 103 103
103 103 103 103 103 103 103 103 103 103 103 103 103 103 103 103 103 103 103 103 103 103 103 103 103 103 103 103 103 103 103 103 103 103 103 103 103 103 103 103
103 103 103 103 103 103 103 103 103 103 103 103 103 103 103 103 103 103 103 103 103 103 103 103 103 103 103 103 103 103 103 103 103 103 103 103 103 103 103 103