40 40
32 32
103 103 103 103 103 103 103 103 103 103 103 103 103 103 103 103 103 103 103 103 103 103 103 103 103 103 103 103 103 103 103 103 103 103 103 103 103 103 103 103
103 131 131 131 131 131 131 131 131 103 011 109 109 109 109 109 109 109 109 109 109 109 109 109 109 109 103 131 131 131 131 131 131 131 131 131 131 131 131 103
103 131 131 131 131 131 131 131 131 103 011 109 109 109 109 109 109 107 107 109 109 109 109 109 109 109 103 131 131 131 131 131 131 131 131 131 131 131 131 103
103 131 131 131 131 131 131 131 131 103 011 109 109 109 109 109 109 107 107 109 109 109 109 109 109 109 103 131 131 131 131 131 131 131 131 131 131 131 131 103
103 131 131 131 131 131 131 131 131 103 011 109 109 109 109 109 109 107 107 109 109 109 109 109 109 109 103 131 131 131 131 131 131 131 131 131 131 131 131 103
103 120 131 131 131 131 131 131 131 103 011 109 109 109 109 109 109 109 109 109 109 109 109 109 109 109 103 131 131 131 131 131 131 131 131 131 131 131 131 103
103 121 131 131 131 131 131 103 131 103 011 109 109 109 109 109 109 109 109 109 109 109 109 109 109 109 103 131 131 131 131 131 131 131 131 131 131 131 131 103
103 122 131 131 131 131 131 131 131 103 011 109 109 109 109 109 109 109 109 109 109 109 109 109 109 109 103 131 131 131 131 131 131 131 131 131 131 131 131 103
103 123 131 131 131 131 131 131 131 103 011 109 109 109 109 109 109 109 109 109 109 109 109 109 109 109 103 131 131 131 131 131 131 131 131 131 131 131 131 103
103 124 131 131 131 131 131 131 131 103 011 109 109 109 109 109 109 109 109 109 109 109 109 109 109 109 103 131 131 131 131 131 131 131 131 131 131 131 131 103
103 125 131 131 131 131 131 131 131 103 011 109 109 109 109 109 109 109 109 109 109 109 109 109 109 109 103 131 131 131 131 131 131 131 131 131 131 131 131 103
103 126 131 131 131 131 131 131 131 103 011 109 109 109 109 109 109 109 109 109 109 109 109 109 109 109 103 131 131 131 131 131 131 131 131 131 131 131 131 103
103 127 131 131 131 131 131 131 131 131 131 131 131 131 131 131 131 131 131 131 131 131 131 131 131 131 131 131 131 131 131 131 131 131 131 131 131 131 131 103
103 128 131 131 131 131 131 131 131 131 131 131 131 131 131 131 131 131 131 131 131 131 131 131 131 131 131 131 131 131 131 131 131 131 131 131 131 131 131 103
103 129 131 131 131 131 131 131 131 131 131 131 131 110 110 110 110 131 131 131 131 131 131 131 131 131 131 131 131 131 131 131 131 131 131 131 131 131 131 103
103 130 131 131 131 131 131 131 131 131 131 131 131 110 110 110 110 131 131 131 131 131 131 131 131 131 131 131 131 131 131 131 131 131 131 131 131 131 131 103
103 131 131 131 131 131 131 131 131 131 131 131 131 111 111 112 111 131 131 131 131 131 131 131 131 131 131 131 131 131 131 131 131 131 131 131 131 131 131 103
103 131 131 131 131 131 131 131 131 131 131 131 131 131 131 131 131 131 131 131 131 131 131 131 131 131 131 131 131 131 131 131 131 131 131 131 131 131 131 103
103 131 131 107 107 107 107 107 107 107 107 107 131 131 131 131 131 131 131 131 131 131 131 131 131 131 131 131 131 131 131 131 131 131 131 131 131 131 131 103
103 131 131 107 107 107 107 107 107 107 107 107 131 131 131 131 131 131 131 131 131 131 131 131 131 131 131 131 131 131 131 131 131 131 131 131 131 131 131 103
103 131 131 107 107 107 107 107 107 107 107 107 131 131 131 131 131 131 131 131 131 131 131 131 131 131 131 131 131 131 131 131 131 131 131 131 131 131 131 103
103 131 131 107 107 107 107 107 107 107 107 107 131 131 131 131 131 131 131 131 131 131 131 131 131 131 131 131 131 131 131 131 131 131 131 131 131 131 131 103
103 131 131 107 107 107 107 107 107 107 107 107 131 131 131 131 131 131 131 131 131 131 131 131 131 131 131 131 131 131 131 131 131 131 131 131 131 131 131 103
103 131 131 107 107 107 107 107 107 107 107 107 131 131 131 131 131 131 131 131 131 131 131 131 131 131 131 131 131 131 131 131 131 131 131 131 131 131 131 103
103 131 131 107 107 107 107 107 107 107 107 107 131 131 131 131 131 131 131 131 131 131 131 131 131 131 131 131 131 131 131 131 131 131 131 131 131 131 131 103
103 131 131 107 107 107 107 107 107 107 107 131 131 131 131 131 131 131 131 131 131 131 131 131 131 131 131 131 131 131 131 131 131 131 131 131 131 131 131 103
103 131 131 107 107 107 107 107 107 107 107 131 120 121 121 121 122 132 133 134 131 131 131 131 131 131 131 131 131 131 131 131 131 131 131 131 131 131 131 103
103 131 131 107 107 107 107 107 107 107 107 131 123 124 124 124 125 135 136 137 131 131 131 131 131 131 131 131 131 131 131 131 131 131 131 131 131 131 131 103
103 131 131 107 107 107 107 107 107 107 107 131 123 124 124 124 125 138 139 140 131 131 131 131 131 131 131 131 131 131 131 131 131 131 131 131 131 131 131 103
103 131 131 107 107 107 107 107 107 107 107 131 123 124 124 124 125 131 142 141 131 131 131 131 131 131 131 131 131 131 131 131 131 131 131 131 131 131 131 103
103 131 131 107 107 107 107 107 107 107 107 131 123 124 124 124 125 131 131 131 131 131 131 131 131 131 131 131 131 131 131 131 131 131 131 131 131 131 131 103
103 131 131 107 107 107 107 107 107 107 107 131 126 127 127 127 128 131 131 131 131 131 131 131 131 131 131 131 131 131 131 131 131 131 131 131 131 131 131 103
103 131 131 107 107 107 107 107 107 107 107 131 131 131 131 131 131 131 131 131 131 131 131 131 131 131 131 131 131 131 131 131 131 131 131 131 131 131 131 103
103 131 131 107 107 107 107 107 107 107 107 131 131 131 131 131 131 131 131 131 131 131 131 131 131 131 131 131 131 131 131 131 131 131 131 131 131 131 131 103
103 131 131 107 107 107 107 107 107 107 107 131 131 131 131 131 131 131 131 131 131 131 131 131 131 131 131 131 131 131 131 131 131 131 131 131 131 131 131 103
103 131 131 107 107 107 107 107 107 107 107 131 131 131 131 131 131 131 131 131 131 131 131 131 131 131 131 131 131 131 131 131 131 131 131 131 131 131 131 103
103 131 131 107 107 107 107 107 107 107 107 107 131 131 131 112 131 131 131 131 131 131 131 131 131 131 131 131 131 131 131 131 131 131 131 131 131 131 131 103
103 103 103 103 103 103 103 103 103 103 103 103 103 103 103 103 103 103 103 103 103 103 103 103 103 103 103 103 103 103 103 103 103 103 103 103 103 103 103 103
103 103 103 103 103 103 103 103 103 103 103 103 103 103 103 103 103 103 103 103 103 103 103 103 103 103 103 103 103 103 103 103 103 103 103 103 103 103 103 103
103 103 103 103 103 103 103 103 103 103 103 103 103 103 103 103 103 103 103 103 103 103 103 103 103 103 103 103 103 103 103 103 103 103 103 103 103 103 103 103
