32 32
60 60
3 3 3 3 3 3 3 3 3 3 3 3 3 3 3 3 3 3 3 3
3 8 8 8 8 8 8 8 8 8 8 8 8 8 8 8 8 8 8 3
3 8 8 8 8 8 8 8 8 8 8 8 8 8 8 8 8 8 8 3
3 8 8 8 8 8 8 8 8 8 8 8 8 8 8 8 8 8 8 3
3 8 8 8 8 8 8 8 8 8 8 8 8 8 8 8 8 8 8 3
3 8 8 8 8 8 8 8 8 8 8 8 8 8 8 8 8 8 8 3 
3 8 8 8 8 8 8 8 8 8 8 8 8 8 8 8 8 8 8 3
3 8 8 8 8 8 8 8 8 8 8 8 8 8 8 8 8 8 8 3
3 8 8 8 8 8 8 8 8 8 8 8 8 8 8 8 8 8 8 3
3 8 8 8 8 8 8 8 8 8 8 8 8 8 8 8 8 8 8 3
3 8 8 8 8 8 8 8 8 8 8 8 8 8 8 8 8 8 8 3 
3 8 8 8 8 8 8 8 8 8 8 8 8 8 8 8 8 8 8 3
3 8 8 8 8 8 8 8 8 8 8 8 8 8 8 8 8 8 8 3
3 8 8 8 8 8 8 8 8 8 8 8 8 8 8 8 8 8 8 3
3 8 8 8 8 8 8 8 8 8 8 8 8 8 8 8 8 8 8 3
3 8 8 8 8 8 8 8 8 8 8 8 8 8 8 8 8 8 8 3 
3 8 8 8 8 8 8 1 0 0 0 1 8 8 8 8 8 8 8 3
3 8 8 8 8 8 8 1 0 0 0 1 8 8 8 8 8 8 8 3
3 8 8 8 8 8 8 1 0 0 0 1 8 8 8 8 8 8 8 3
3 3 3 3 3 3 3 3 3 3 3 3 3 3 3 3 3 3 3 3